aaaaaaaaaaaaaaaaaaaaaaaaaaaaaaaaaaaaaaaa
a``````````````````````````````````````a
a``````````````````````````````````````a
a``````````````````````````````````````a
a``````````````````````````````````````a
a``````````````````````````````````````a
a``````````````````````````````````````a
a``````````````````````````````````````a
a``````````````````````````````````````a
a``````````````````````````````````````a
a``````````````````````````````````````a
a``````````````````````````````````````a
a``````````````````````````````````````a
a``````````````````````````````````````a
a``````````````````````````````````````a
a``````````````````````````````````````a
a``````````````````````````````````````a
a``````````````````````````````````````a
a``````````````````````````````````````a
a``````````````````````````````````````a
a``````````````````````````````````````a
a``````````````````````````````````````a
a``````````````````````````````````````a
a``````````````````````````````````````a
a``````````````````````````````````````a
a``````````````````````````````````````a
a```````j````k`````````````````````````a
a``i```````````````d``e````````````````a
a``````````````````````````````````````a
a````hh````````````````````````````````a
aaaaaaaaaaaaaaaaaaaaaaaaaaaaaaaaaaaaaaaa

