0000000000000000000000000000000000000000
0000000000000000000000000000000000000000
0000000000000000000000000000000000000000
0000000000000000000000000000000000000000
0000000000000000000000000000000000000000
0000000000000000000000000000000000000000
0000000000000000000000000000000000000000
0000000000000000000000000000000000000000
0000000000000000000000000000000000000000
0000000000000000000000000000000000000000
0000000000000000000000000000000000000000
0000000000000000000000000000000000000000
0000000000000000000000000000000000000000
0000000000000000000000000000000000000000
0000000000000000000000000000000000000000
0000000000000000000000000000000000000000
0000000000000000000000000000000000000000
0000002111111111111111111111111111111111
0000002000000000000000000000000000000000
0000002000000000000000000000000000000000
0000002000000000000000000000000000000000
0000002000000000000000000000000000000000
1111111113011111111111111111111111100000
0000000000000000000000000000000000000000
0000000000000000000000000000000000000000
0000000000000000000000000000000000000000
0000000000000000000000000000000000022222
0000000000000000000000000000000000000000
0000000000000000000000000000000000000000
0000000000000000000000000000000000000000
1111111111111111111111111111111301111111

[(39, 26), (38, 26), (37, 26), (36, 26), (35, 26)]; [(31, 30), (32, 30)]
[(6, 21), (6, 20), (6, 19), (6, 18), (6, 17)]; [(9, 22), (10, 22)]
