1111111111111111111111111111111111111111
1000000000000000000000000000000000000001
1000000000000000000000000000000000000001
1000000000000000000000000000005000400001
1000000000000000000000000000000000000001
1000000000000000000000000000000000000001
1000000000000000111111111111111111111111
1000000000000000000000000000000000000001
1000000000000000000000000000000000000001
1000000000000000000000000000000000000001
1000011111111000000000000000000000000001
1000000000000000000000000000000000000001
1000000000000000000000000000000000000001
1000000000000000000000000000000000000001
1000000000000000000000000000000000000001
1111100000000200000000000000000000000001
1000110000000200000000000000000000000001
1000011000000200000000000000000000000001
1000001100000200000000000000000000000001
1000000110000200000000000000000000000001
1000000011111111301111111111111111000001
1000000000000000000000000000000000000001
1000000000000000000000000000000000000001
1000000000000000000000000000000000000001
1000000000000000000000000000000000000001
1000000000000000000111111111301111222221
1000000000000000001100000001111000000001
1000000000000000011000000000000000000001
1000000000000000110000000000000000000001
1000000000000001100000000000000000000001
1111111111111111111111111111111111111111

[(34, 25), (35, 25), (36, 25), (37, 25), (38, 25)]; [(28, 25)]
[(13, 19), (13, 18), (13, 17), (13, 16), (13, 15)]; [(16, 20)]
