1111111111111111111111111111111111111111
1000000000000000000000000000000000000001
1000000000000000000000000000000000000001
1000000000000000000000000000000000000001
1000000000000000000000000000000000000001
1000000000000000000000000000000000000001
1000000000000000000000000000000000000001
1000000000000000000000000000000000000001
1000000000000000000000000000000000000001
1000000000000000000000000000000000000001
1000000000000000000000000000000000000001
1000000000000000000000000000000000000001
1000000000000000000000000000000000000001
1000000000000000000000000000000000000001
1000000000000000000000000000000000000001
1000000000000000000000000000000000000001
1000000000000000000000000000000000000001
1000000000000000000000000000000000000001
1000000000000000000000000000000000000001
1000000000000000000000000000500040000001
1000000000000000000000000000000000000001
1000000000000000000000000000000000000001
1000000000000000000000001111111111111111
1000000000000000000000000000000000000001
1000000000000000000000000000000000000001
1000000000000000030000000000000000000001
1000000000000000011222220000000000000001
1000000000000000110000000000000000000001
1000000000000001100000000000000000000001
1000000000000011100000000000000000000001
1111111111111111111111111111111111111111

