1111111111111111111111111111111111111111
1000000000000000000000000000000000000001
1000000000000000000000000000000000000001
1000000000000000000000000000000000000001
1000000000000000000000000000000000000001
1000000000000000000000000000000000000001
1000000000000000000000000000000000000001
1000000000000011100000000000000000000001
1000000000000000010000000000000500040001
1000000000000000001000000000000000000001
1000000000000000000100000000000000000001
1000000001111000000011111111111111111111
1000000000001000000000000000000000000001
1000111000001000000000000000000000000001
1000000000001000000000000000000000000001
1000000000001000000000000000000000000001
1000000000001000000000000000000000000001
1000000000002000000000000000000000000001
1111000000002000000000000000000000000001
1000000000002000000000000000000000000001
1000000000002000000000000000000000000001
1000000000002000000000000000000000000001
1000111111111111130111111301111111000001
1000000000000000000000000000000000000001
1000000000000000000000000000000000000001
1000000000000000000000000000000000000001
1000000000000000000000000000000000000001
1000000000000011111111111301111111222221
1000000000000110000000000000000000000001
1000000000001100000000000000000000000001
1111111111111111111111111111111111111111

[(34, 27), (35, 27), (36, 27), (37, 27), (38, 27)]; [(25, 27), (25, 22)]
[(12, 21), (12, 20), (12, 19), (12, 18), (12, 17)]; [(17, 22)]
