1111111111111111111111111111111111111111
1000000000000000000000000000000000000001
1001100000100000010000000100000000000001
1001010000100000101000000100000000000001
1001010001010000101000001010000000000001
1001100001010001000100001010000000000001
1001010001010001000100001010000000000001
1001010010001001111100111111100000000001
1001010010001001000100100000100000000001
1001100010001001000100010001000000000001
1000000000000000000000000000000000000001
1000000000000000000000000000000000000001
1000000000000000000000000000000000000001
1000000000000000000000000000000000000001
1000000000000000100100110001100111110001
1000000000000000100100101010100100010001
1000000000000000100100100100100100010001
1000000000000000011100100000100100010001
1000000000000000000100100000100100010001
1000000000000000000100100000100100010001
1000000000000000000100100000100100010001
1000000000000000000100100000100111110001
1000000000000000000000000000000000000001
1000000000000000000000000000000000000001
1000000000000000000000000000000000000001
1000000000000000000000000000000000000001
1000000000000000000000000000000000000001
1000000000000000000000000000000000000001
1000000000000000000000000000000000000001
1000000000000000000000000000000000000001
1111111111111111111111111111111111111111

