1111111111111111111111111111111111111111
1000000000000000000000000000000000000001
1000000000000000000000000000000000000001
1000000000000000000000000000000000000001
1000000000000000000000000000000000000001
1000000000000000000000000000000000000001
1000000000000000000000000000000000000001
1000000000000000000000000000000000000001
1000000000000000000000000000000000000001
1000000000000000000000000000000000000001
1000000000000000000000000000000000000001
1000000000000000000000000000000000000001
1000000000000000000000000000000000000001
1000000000000000000000000000000000000001
1000000000000000000000000000000000000001
1000000000000000000000000000000000000001
1000000000000000000000000000000000000001
1000000000000000000000000000000000000001
1000000000000000000000000000000000000001
1000000000000000000000000000000000000001
1000000000000000000000000000000000000001
1000000010000000000000000000000000000001
1000000101000000000000000000000000000001
1000000111000000000000000010000000000001
1000000101000000000000000001000000000001
1000000000000000000000000000000000000001
1000000101000100011101110100010000101111
1000000101001010010101000100110001101011
1000000111011111011101110101010001101011
1000000101010001010001000110010010101111
1111111111111111111111111111111111111111

